level1
10 _  _  _  _  _  _  _  _  _  3  _  8
10 _  _  _  _  9  X  _  _  _  _  _  8
10 _  _  _  _  _  9  9  9  9  |  _  8
10 _  _  _  _  _  _  _  _  _  _  _  8
10 FH _  _  _  _  _  _  _  _  _  _  8
10 _  _  _  _  _  _  _  _  _  _  _  8
10 _  _  _  _  _  _  _  _  FV _  F  8
9  6  _  _  _  _  _  _  _  _  _  4  9
9  9  6  _  P  SU _  B  _  _  _  8  9
9  9  9  5  5  5  5  5  5  5  5  9  9
