level10
10 _  _  _  _  _  _  _  _  _  _  _  8
10 _  _  _  _  _  _  _  _  _  _  _  8
10 X  _  _  SU _  _  _  SU SU _  _  8
13 1  1  1  1  1  1  1  1  2  _  _  8
_  _  _  _  _  _  _  _  _  _  _  _  8
5  2  _  _  _  _  _  _  _  _  _  _  8
10 _  _  _  _  _  _  _  _  _  _  _  8
10 _  _  _  _  _  _  _  7  _  _  _  8
10 F  _  _  B  SU SU SU 8  6  _  _  8
9  5  5  5  5  5  5  5  9  9  5  5  9
