level6
_  _  _  _  _  _  _  _  _  _  _  _  _
_  _  _  _  _  _  _  _  _  _  _  _  4
_  _  _  _  _  _  _  _  _  _  _  _  8
6  _  _  _  _  _  _  _  _  _  _  _  8
10 _  _  _  _  _  _  _  _  _  _  _  8
10 _  _  _  _  _  _  _  _  _  _  _  8
10 _  _  _  FH _  _  _  _  _  _  _  8
10 X  _  _  FH _  _  B  _  _  _  F  8
9  5  5  6  B  4  5  6  _  4  5  5  9
9  9  9  9  5  9  9  9  5  9  9  9  9
