END
10 _  _  _  _  _  _  _  _  _  _  _  8
10 _  _  _  _  _  _  _  _  _  _  _  8
10 _  _  _  _  _  _  _  _  _  _  _  8
10 _  _  _  _  _  _  _  _  _  _  _  8
10 _  _  _  _  _  _  _  _  _  _  _  8
10 X  _  _  _  _  _  FH _  _  _  _  8
9  5  6  =  _  _  _  _  7  _  _  _  8
9  9  10 SU SU SU SU SU 11 _  _  _  8
9  9  9  5  5  5  5  5  9  W  W  W  9
9  9  9  9  9  9  9  9  9  9  9  9  9
