level3
10 _  _  _  _  _  _  _  _  _  _  _  8
10 F  _  _  _  _  _  _  B  _  _  _  8
9  2  =  _  _  _  _  _  0  2  _  _  8
10 _  _  _  _  _  _  _  _  _  _  P  8
10 _  _  _  _  _  _  _  _  _  _  0  9
10 _  _  _  _  _  _  _  _  7  _  _  8
10 _  _  _  _  _  _  0  1  13 2  _  8
10 _  _  _  _  _  _  _  _  _  _  _  8
10 X  _  _  _  _  _  _  _  _  FH P  8
9  5  5  5  5  5  5  5  5  5  5  5  9
