level4
10 _  _  _  _  _  _  _  _  _  _  0  9
10 _  _  _  _  _  _  F  _  _  _  _  8
10 _  _  4  6  B  _  0  1  1  2  _  8
10 _  _  8  9  6  _  _  _  _  _  _  8
10 _  _  12 13 14 _  _  _  _  FV _  8
10 _  _  SD SD SD _  _  _  FV _  _  8
10 _  _  _  _  _  _  _  FV _  _  _  8
10 _  _  _  _  _  _  FV _  _  _  |  8
10 X  _  _  P  _  _  _  _  _  _  _  8
9  5  5  5  5  5  5  5  5  5  5  5  9
