level8
10 _  _  _  _  _  _  _  _  _  _  _  8
10 _  _  _  _  _  _  _  _  _  _  _  8
10 _  _  _  _  _  _  _  _  _  _  _  8
10 _  _  _  _  _  _  _  _  _  _  _  8
10 _  _  _  _  _  _  _  _  7  _  _  8
10 _  _  _  P  _  _  _  _  11 _  _  8
10 _  _  _  0  1  1  2  _  11 _  _  8
10 FH _  _  _  _  _  _  _  11 _  _  8
10 X  _  _  FH _  _  _  P  11 _  F  8
9  5  5  5  5  5  5  5  5  9  5  5  9
