level9
10 _  _  _  _  _  _  _  _  _  _  _  8
10 _  _  _  _  _  _  _  _  _  _  _  8
10 X  _  _  P  _  _  _  _  _  _  FH 8
9  5  1  1  1  1  _  _  _  _  _  _  8
9  14 _  _  _  _  _  _  _  _  _  _  8
10 _  _  _  _  _  =  SU SU SU SU SU 8
9  5  6  _  _  _  0  1  1  1  1  1  9
9  9  10 _  _  _  _  _  _  _  _  F  8
9  9  10 _  _  _  _  _  _  _  P  4  9
9  9  9  5  5  5  5  5  5  5  5  9  9
